"filename", "language", "Python", "XML", "comment", "blank", "total"
"/Users/alessandrosalerno/Documents/KeyFire/.idea/KeyFire.iml", "XML", 0, 8, 0, 0, 8
"/Users/alessandrosalerno/Documents/KeyFire/.idea/inspectionProfiles/profiles_settings.xml", "XML", 0, 6, 0, 0, 6
"/Users/alessandrosalerno/Documents/KeyFire/.idea/misc.xml", "XML", 0, 4, 0, 0, 4
"/Users/alessandrosalerno/Documents/KeyFire/.idea/modules.xml", "XML", 0, 8, 0, 0, 8
"/Users/alessandrosalerno/Documents/KeyFire/.idea/workspace.xml", "XML", 0, 222, 0, 0, 222
"/Users/alessandrosalerno/Documents/KeyFire/KeyFire/GUI/__init__.py", "Python", 0, 0, 48, 4, 52
"/Users/alessandrosalerno/Documents/KeyFire/KeyFire/GUI/label.py", "Python", 37, 0, 100, 27, 164
"/Users/alessandrosalerno/Documents/KeyFire/KeyFire/GUI/sprite.py", "Python", 9, 0, 59, 13, 81
"/Users/alessandrosalerno/Documents/KeyFire/KeyFire/__init__.py", "Python", 0, 0, 48, 4, 52
"/Users/alessandrosalerno/Documents/KeyFire/KeyFire/audio/__init__.py", "Python", 0, 0, 48, 4, 52
"/Users/alessandrosalerno/Documents/KeyFire/KeyFire/audio/music.py", "Python", 11, 0, 67, 14, 92
"/Users/alessandrosalerno/Documents/KeyFire/KeyFire/audio/sound.py", "Python", 15, 0, 76, 19, 110
"/Users/alessandrosalerno/Documents/KeyFire/KeyFire/engine.py", "Python", 53, 0, 57, 34, 144
"/Users/alessandrosalerno/Documents/KeyFire/KeyFire/entities/__init__.py", "Python", 0, 0, 48, 4, 52
"/Users/alessandrosalerno/Documents/KeyFire/KeyFire/entities/cube.py", "Python", 49, 0, 84, 31, 164
"/Users/alessandrosalerno/Documents/KeyFire/KeyFire/entities/object.py", "Python", 18, 0, 100, 25, 143
"/Users/alessandrosalerno/Documents/KeyFire/KeyFire/entities/particle_system.py", "Python", 69, 0, 125, 51, 245
"/Users/alessandrosalerno/Documents/KeyFire/KeyFire/entities/square.py", "Python", 81, 0, 118, 62, 261
"/Users/alessandrosalerno/Documents/KeyFire/KeyFire/input/__init__.py", "Python", 0, 0, 48, 4, 52
"/Users/alessandrosalerno/Documents/KeyFire/KeyFire/input/keyboard.py", "Python", 8, 0, 67, 14, 89
"/Users/alessandrosalerno/Documents/KeyFire/KeyFire/log.py", "Python", 72, 0, 102, 35, 209
"/Users/alessandrosalerno/Documents/KeyFire/KeyFire/maths/__init__.py", "Python", 0, 0, 48, 4, 52
"/Users/alessandrosalerno/Documents/KeyFire/KeyFire/maths/math.py", "Python", 8, 0, 57, 10, 75
"/Users/alessandrosalerno/Documents/KeyFire/KeyFire/texturing/__init__.py", "Python", 0, 0, 48, 4, 52
"/Users/alessandrosalerno/Documents/KeyFire/KeyFire/texturing/material.py", "Python", 8, 0, 56, 10, 74
"/Users/alessandrosalerno/Documents/KeyFire/KeyFire/texturing/texture.py", "Python", 76, 0, 68, 38, 182
"/Users/alessandrosalerno/Documents/KeyFire/KeyFire/values.py", "Python", 35, 0, 48, 10, 93
"/Users/alessandrosalerno/Documents/KeyFire/KeyFire/video/__init__.py", "Python", 0, 0, 48, 4, 52
"/Users/alessandrosalerno/Documents/KeyFire/KeyFire/video/camera.py", "Python", 144, 0, 107, 73, 324
"/Users/alessandrosalerno/Documents/KeyFire/KeyFire/video/graphics.py", "Python", 31, 0, 78, 25, 134
"/Users/alessandrosalerno/Documents/KeyFire/KeyFire/video/light.py", "Python", 26, 0, 72, 20, 118
"/Users/alessandrosalerno/Documents/KeyFire/KeyFire/video/scene.py", "Python", 23, 0, 60, 17, 100
"/Users/alessandrosalerno/Documents/KeyFire/KeyFire/video/window.py", "Python", 109, 0, 160, 74, 343
"/Users/alessandrosalerno/Documents/KeyFire/KeyFire/world/__init__.py", "Python", 0, 0, 48, 4, 52
"/Users/alessandrosalerno/Documents/KeyFire/KeyFire/world/format.py", "Python", 29, 0, 99, 35, 163
"/Users/alessandrosalerno/Documents/KeyFire/assets/python/noise_gen.py", "Python", 51, 0, 0, 14, 65
"/Users/alessandrosalerno/Documents/KeyFire/console.py", "Python", 49, 0, 48, 31, 128
"/Users/alessandrosalerno/Documents/KeyFire/locals.py", "Python", 35, 0, 52, 5, 92
"/Users/alessandrosalerno/Documents/KeyFire/main.py", "Python", 8, 0, 53, 9, 70
"/Users/alessandrosalerno/Documents/KeyFire/scripts/__init__.py", "Python", 0, 0, 48, 4, 52
"/Users/alessandrosalerno/Documents/KeyFire/tzylang.py", "Python", 155, 0, 14, 44, 213
"Total", "-", 1209, 248, 2407, 780, 4644