"filename", "language", "Python", "XML", "comment", "blank", "total"
"x:\Programming\Python\KeyFire\.idea\KeyFire.iml", "XML", 0, 8, 0, 0, 8
"x:\Programming\Python\KeyFire\.idea\inspectionProfiles\profiles_settings.xml", "XML", 0, 6, 0, 0, 6
"x:\Programming\Python\KeyFire\.idea\misc.xml", "XML", 0, 4, 0, 0, 4
"x:\Programming\Python\KeyFire\.idea\modules.xml", "XML", 0, 8, 0, 0, 8
"x:\Programming\Python\KeyFire\.idea\workspace.xml", "XML", 0, 222, 0, 0, 222
"x:\Programming\Python\KeyFire\KeyFire\GUI\__init__.py", "Python", 0, 0, 48, 4, 52
"x:\Programming\Python\KeyFire\KeyFire\GUI\label.py", "Python", 37, 0, 100, 27, 164
"x:\Programming\Python\KeyFire\KeyFire\GUI\sprite.py", "Python", 9, 0, 59, 13, 81
"x:\Programming\Python\KeyFire\KeyFire\__init__.py", "Python", 0, 0, 48, 4, 52
"x:\Programming\Python\KeyFire\KeyFire\audio\__init__.py", "Python", 0, 0, 48, 4, 52
"x:\Programming\Python\KeyFire\KeyFire\audio\music.py", "Python", 11, 0, 67, 14, 92
"x:\Programming\Python\KeyFire\KeyFire\audio\sound.py", "Python", 15, 0, 76, 19, 110
"x:\Programming\Python\KeyFire\KeyFire\engine.py", "Python", 53, 0, 57, 34, 144
"x:\Programming\Python\KeyFire\KeyFire\entities\__init__.py", "Python", 0, 0, 48, 4, 52
"x:\Programming\Python\KeyFire\KeyFire\entities\cube.py", "Python", 49, 0, 84, 31, 164
"x:\Programming\Python\KeyFire\KeyFire\entities\object.py", "Python", 18, 0, 100, 25, 143
"x:\Programming\Python\KeyFire\KeyFire\entities\particle_system.py", "Python", 69, 0, 125, 51, 245
"x:\Programming\Python\KeyFire\KeyFire\entities\square.py", "Python", 81, 0, 118, 62, 261
"x:\Programming\Python\KeyFire\KeyFire\input\__init__.py", "Python", 0, 0, 48, 4, 52
"x:\Programming\Python\KeyFire\KeyFire\input\keyboard.py", "Python", 8, 0, 67, 14, 89
"x:\Programming\Python\KeyFire\KeyFire\log.py", "Python", 65, 0, 102, 36, 203
"x:\Programming\Python\KeyFire\KeyFire\maths\__init__.py", "Python", 0, 0, 48, 4, 52
"x:\Programming\Python\KeyFire\KeyFire\maths\math.py", "Python", 8, 0, 57, 10, 75
"x:\Programming\Python\KeyFire\KeyFire\texturing\__init__.py", "Python", 0, 0, 48, 4, 52
"x:\Programming\Python\KeyFire\KeyFire\texturing\material.py", "Python", 8, 0, 56, 10, 74
"x:\Programming\Python\KeyFire\KeyFire\texturing\texture.py", "Python", 76, 0, 68, 38, 182
"x:\Programming\Python\KeyFire\KeyFire\values.py", "Python", 35, 0, 48, 10, 93
"x:\Programming\Python\KeyFire\KeyFire\video\__init__.py", "Python", 0, 0, 48, 4, 52
"x:\Programming\Python\KeyFire\KeyFire\video\camera.py", "Python", 149, 0, 107, 72, 328
"x:\Programming\Python\KeyFire\KeyFire\video\graphics.py", "Python", 31, 0, 78, 25, 134
"x:\Programming\Python\KeyFire\KeyFire\video\light.py", "Python", 26, 0, 72, 20, 118
"x:\Programming\Python\KeyFire\KeyFire\video\scene.py", "Python", 20, 0, 59, 13, 92
"x:\Programming\Python\KeyFire\KeyFire\video\window.py", "Python", 109, 0, 160, 74, 343
"x:\Programming\Python\KeyFire\KeyFire\world\__init__.py", "Python", 0, 0, 48, 4, 52
"x:\Programming\Python\KeyFire\KeyFire\world\format.py", "Python", 29, 0, 99, 35, 163
"x:\Programming\Python\KeyFire\assets\python\noise_gen.py", "Python", 51, 0, 0, 14, 65
"x:\Programming\Python\KeyFire\console.py", "Python", 73, 0, 53, 35, 161
"x:\Programming\Python\KeyFire\disassembler.py", "Python", 6, 0, 0, 2, 8
"x:\Programming\Python\KeyFire\locals.py", "Python", 35, 0, 52, 5, 92
"x:\Programming\Python\KeyFire\main.py", "Python", 10, 0, 53, 8, 71
"x:\Programming\Python\KeyFire\scripts\__init__.py", "Python", 0, 0, 48, 4, 52
"x:\Programming\Python\KeyFire\tzylang.py", "Python", 155, 0, 14, 44, 213
"Total", "-", 1236, 248, 2411, 781, 4676